1111111111
1        1
1   213  1
1    1   1
1    1  41
112 4    1
1        1
1   4  111
1        1
1111111111